...............
...XXXX.XXXX...
...X.......X...
...X.......X...
...X.......X...
...X...........
...X.G.........
...X...........
...X.......X...
...X.......X...
...X.......X...
...XXXX.XXXX...
...............
...............
