.............
.............
...XXXXXXX...
...........G.
...XXXXXXX...
